00 31 00 18 19 19 19 19 19 19 29 00 00 00 28 19 19 19 19 19 19 20 00 00 30
00 00 18 29 00 00 00 00 00 00 00 00 00 00 00 00 00 00 00 00 00 28 20 00 00
18 19 29 00 00 00 00 00 00 00 02 03 03 03 04 00 00 00 00 31 00 00 28 19 20
29 00 00 00 00 00 02 03 03 03 14 06 06 06 13 03 03 03 04 00 00 00 00 00 22
00 00 00 00 02 03 14 06 06 06 06 16 06 06 06 15 06 06 13 03 03 04 00 00 22
00 00 00 02 14 06 06 06 06 06 06 06 06 06 06 06 06 06 06 06 06 07 00 00 28
00 30 00 05 06 06 06 06 06 17 06 06 06 06 06 06 17 06 06 06 06 07 00 00 00 
00 00 00 05 06 06 06 06 06 06 06 06 06 06 06 06 06 06 06 06 06 13 04 00 00
03 03 03 14 06 06 15 06 06 06 06 06 06 06 06 06 06 06 06 06 06 06 13 03 03
09 09 09 12 06 06 06 06 06 06 06 06 06 06 17 06 06 06 16 06 06 06 11 09 09
00 00 00 05 06 06 06 06 06 06 06 06 06 06 06 06 06 06 06 06 06 11 10 00 00
00 00 00 05 06 06 06 06 16 06 06 06 06 06 06 06 06 06 06 06 11 10 00 00 00
00 00 00 08 12 06 06 06 06 06 06 06 06 06 06 06 06 06 06 06 07 00 00 00 32 
00 00 00 31 08 09 12 06 06 06 06 06 06 06 15 06 06 06 11 09 10 00 00 00 00
34 35 00 00 00 00 08 09 09 09 12 06 06 06 11 09 09 09 10 32 00 00 33 34 34
01 43 35 00 00 00 00 00 30 00 08 09 09 09 10 00 00 00 00 00 00 33 44 01 01
01 01 43 34 34 34 35 00 00 00 00 00 31 00 00 00 00 33 34 34 34 44 45 01 01
47 01 01 01 01 47 43 34 34 34 34 34 34 34 34 34 34 44 46 01 01 01 01 01 01
01 01 01 01 01 01 01 01 01 01 01 01 01 01 01 01 01 01 01 01 01 01 01 46 01