0 31 0 18 19 19 19 19 19 19 29 0 0 0 28 19 19 19 19 19 19 20 0 0 30
0 0 18 29 0 0 0 0 0 0 0 0 0 0 0 0 0 0 0 0 0 28 20 0 0
18 19 29 0 0 0 0 0 0 0 2 3 3 3 4 0 0 0 0 31 0 0 28 19 20
29 0 0 0 0 0 2 3 3 3 14 6 6 6 13 3 3 3 4 0 0 0 0 0 22
0 0 0 0 2 3 14 6 6 6 6 16 6 6 6 15 6 6 13 3 3 4 0 0 22
0 0 0 2 14 6 6 6 6 6 6 6 6 6 6 6 6 6 6 6 6 7 0 0 28
0 30 0 5 6 6 6 6 6 17 6 6 6 6 6 6 17 6 6 6 6 7 0 0 0
0 0 0 5 6 6 6 6 6 6 6 6 6 6 6 6 6 6 6 6 6 13 4 0 0
3 3 3 14 6 6 15 6 6 6 6 6 6 6 6 6 6 6 6 6 6 6 13 3 3
9 9 9 12 6 6 6 6 6 6 6 6 6 6 17 6 6 6 16 6 6 6 11 9 9
0 0 0 5 6 6 6 6 6 6 6 6 6 6 6 6 6 6 6 6 6 11 10 0 0
0 0 0 5 6 6 6 6 16 6 6 6 6 6 6 6 6 6 6 6 11 10 0 0 0
0 0 0 8 12 6 6 6 6 6 6 6 6 6 6 6 6 6 6 6 7 0 0 0 0
0 0 0 0 8 9 12 6 6 6 6 6 6 6 15 6 6 6 11 9 10 0 0 0 0
0 0 0 0 0 0 8 9 9 9 12 6 6 6 11 9 9 9 10 0 0 0 0 0 0
0 0 0 0 0 0 0 0 0 0 8 9 9 9 10 0 0 0 0 0 0 0 0 0 0
0 0 0 0 0 0 0 0 0 0 0 0 0 0 0 0 0 0 0 0 0 0 0 0 0
0 0 0 0 0 0 0 0 0 0 0 0 0 0 0 0 0 0 0 0 0 0 0 0 0